#### #####
#        #
#        #
#        #
#    #####
#    #   #
#    # # #
#    ### #
#        #
##########

Thief,4,1
Thief,1,2
Thief,3,3
Door,4,0,room1,4,9