##########
#        #
#        #
#        #
######## #
#        #
#        #
#        #
#        #
##########

Bat,7,5
Bat,7,6
Bat,7,7
Bat,7,8
Bat,8,5
Bat,8,6
Bat,8,7
Bat,8,8
Sword,1,5