##########
#        #
##########
#       ##
#        #
#       ##
#        #
#        #
#        #
##########

Sword,2,1
Thief,8,1